######################################################################################################################################################
######################################################################################################################################################
##00000000000000000000000000000000000000000000000000000000000000000000000000000000000000000000000000000000000000000000000000000000000000000000000000##
##00000000000000000000000000000000000000000000000000000000000000000000000000000000000000000000000000000000000000000000000000000000000000000000000000##
##00000000000000000000000000000000000000000000000000000000000000000000000000000000000000000000000000000000000000000000000000000000000000000000000000##
##00000000000000000000000000000000000000000000000000000000000000000000000000000000000000000000000000000000000000000000000000000000000000000000000000##
##00000000000000000000000000000000000000000000000000000000000000000000000000000000000000000000000000000000000000000000000000000000000000000000000000##
##00000000000000000000000000000000000000000000000000000000000000000000000000000000000000000000000000000000000000000000000000000000000000000000000000##
##00000000000000000000000000000000000000000000000000000000000000000000000000000000000000000000000000000000000000000000000000000000000000000000000000##
##00000000000000000000000000000000000000000000000000000000000000000000000000000000000000000000000000000000000000000000000000000000000000000000000000##
##00000000000000000000000000000000000000000000000000000000000000000000000000000000000000000000000000000000000000000000000000000000000000000000000000##
##00000000000000000000000000000000000000000000000000000000000000000000000000000000000000000000000000000000000000000000000000000000000000000000000000##
##00000000000000000000000000000000000000000000000000000000000000000000000000000000000000000000000000000000000000000000000000000000000000000000000000##
##00000000000000000000000000000000000000000000000000000000000000000000000000000000000000000000000000000000000000000000000000000000000000000000000000##
##00000000000000000000000000000000000000000000000000000000000000000000000000000000000000000000000000000000000000000000000000000000000000000000000000##
##00000000000000000000000000000000000000000000000000000000000000000000000000000000000000000000000000000000000000000000000000000000000000000000000000##
##00000000000000000000000000000000000000000000000000000000000000000000000000000000000000000000000000000000000000000000000000000000000000000000000000##
##00000000000000000000000000000000000000000000000000000000000000000000000000000000000000000000000000000000000000000000000000000000000000000000000000##
##00000000000000######000000######000000######000000######000000######000000######000000########000000##00##00##00##00000000000000000000000000000000##
##00000000000000######000000######000000######000000######000000######000000######000000########000000##00##00##00##00000000000000000000000000000000##
##000000000000##000000##00##000000##00##000000##00##000000##00##000000##00##000000##00##00000000000000##00##00##00##00000000000000000000000000000000##
##000000000000##000000##00##000000##00##000000##00##000000##00##000000##00##000000##00##00000000000000##00##00##00##00000000000000000000000000000000##
##000000000000##000000##00##000000##00##000000##00##000000##00##000000##00##000000##00##00000000000000##00##00##00##00000000000000000000000000000000##
##000000000000##000000##00##000000##00##000000##00##000000##00##000000##00##000000##0000######00000000##00##00##00##00000000000000000000000000000000##
##000000000000##000000##00##000000##00##000000##00##000000##00##000000##00##000000##0000######00000000##00##00##00##00000000000000000000000000000000##
##000000000000##000000##00##000000##00##000000##00##000000##00##000000##00##000000##0000000000##000000##00##00##00##00000000000000000000000000000000##
##000000000000##000000##00##000000##00##000000##00##000000##00##000000##00##000000##0000000000##000000##00##00##00##00000000000000000000000000000000##
##000000000000##000000##00##000000##00##000000##00##000000##00##000000##00##000000##0000000000##000000##00##00##00##00000000000000000000000000000000##
##00000000000000######000000######000000######000000######000000######0000########0000##########000000##00##00##00##00000000000000000000000000000000##
##00000000000000######000000######000000######000000######000000######0000########0000########00000000##00##00##00##00000000000000000000000000000000##
##000000000000000000000000000000000000000000000000000000000000000000000000##00000000000000000000000000##00##00##00##00000000000000000000000000000000##
##000000000000000000000000000000000000000000000000000000000000000000000000##000000000000000000000000000000000000000000000000000000000000000000000000##
##000000000000000000000000000000000000000000000000000000000000000000000000##000000000000000000000000000000000000000000000000000000000000000000000000##
##000000000000000000000000000000000000000000000000000000000000000000000000##00000000000000000000000000##00##00##00##00000000000000000000000000000000##
##000000000000000000000000000000000000000000000000000000000000000000000000##00000000000000000000000000##00##00##00##00000000000000000000000000000000##
##000000000000000000000000000000000000000000000000000000000000000000000000##000000000000000000000000000000000000000000000000000000000000000000000000##
##000000000000000000000000000000000000000000000000000000000000000000000000##000000000000000000000000000000000000000000000000000000000000000000000000##
##00000000000000000000000000000000000000000000000000000000000000000000000000000000000000000000000000000000000000000000000000000000000000000000000000##
##00000000000000000000000000000000000000000000000000000000000000000000000000000000000000000000000000000000000000000000000000000000000000000000000000##
##00000000000000000000000000000000000000000000000000000000000000000000000000000000000000000000000000000000000000000000000000000000000000000000000000##
##00000000000000000000000000000000000000000000000000000000000000000000000000000000000000000000000000000000000000000000000000000000000000000000000000##
##00000000000000000000000000000000000000000000000000000000000000000000000000000000000000000000000000000000000000000000000000000000000000000000000000##
##00000000000000000000000000000000000000000000000000000000000000000000000000000000000000000000000000000000000000000000000000000000000000000000000000##
##00000000000000000000000000000000000000000000000000000000000000000000000000000000000000000000000000000000000000000000000000000000000000000000000000##
##00000000000000000000000000000000000000000000000000000000000000000000000000000000000000000000000000000000000000000000000000000000000000000000000000##
##00000000000000000000000000000000000000000000000000000000000000000000000000000000000000000000000000000000000000000000000000000000000000000000000000##
##00000000000000000000000000000000000000000000000000000000000000000000000000000000000000000000000000000000000000000000000000000000000000000000000000##
##00000000000000000000000000000000000000000000000000000000000000000000000000000000000000000000000000000000000000000000000000000000000000000000000000##
######################################################################################################################################################
######################################################################################################################################################
